8
15
###############
#C...........C#
#.#.###=###.#.#
#....#---#....#
#.##.#####.##.#
#.#....#....#.#
#...##. .##...#
###############
